"Starting position of pacman"       
14 7      
"Starting position of ghosts"       
9 7      
"width" "height" "1 = there is" "0 = there is not"    
15 15      
"row" "column" "left wall" "top wall" "right wall" "bottom wall" "pacdot" "powerdot"
0 0 1 1 0 0 0 1
0 1 0 1 0 1 1 0
0 2 0 1 0 1 1 0
0 3 0 1 0 0 1 0
0 4 0 1 0 1 1 0
0 5 0 1 0 1 1 0
0 6 0 1 1 0 1 0
0 7 0 0 0 0 0 0
0 8 1 1 0 0 1 0
0 9 0 1 0 1 1 0
0 10 0 1 0 1 1 0
0 11 0 1 0 0 1 0
0 12 0 1 0 1 1 0
0 13 0 1 0 1 1 0
0 14 0 1 1 0 0 1
1 0 1 0 1 0 1 0
1 1 0 0 0 0 0 0
1 2 0 0 0 0 0 0
1 3 1 0 1 0 1 0
1 4 0 0 0 0 0 0
1 5 0 0 0 0 0 0
1 6 1 0 0 0 1 0
1 7 0 1 0 1 1 0
1 8 0 0 1 0 1 0
1 9 0 0 0 0 0 0
1 10 0 0 0 0 0 0
1 11 1 0 1 0 1 0
1 12 0 0 0 0 0 0
1 13 0 0 0 0 0 0
1 14 1 0 1 0 1 0
2 0 1 0 0 0 1 0
2 1 0 1 0 1 1 0
2 2 0 1 0 1 1 0
2 3 0 0 0 1 1 0
2 4 0 1 0 0 1 0
2 5 0 1 0 1 1 0
2 6 0 0 1 0 1 0
2 7 0 0 0 0 0 0
2 8 1 0 0 0 1 0
2 9 0 1 0 1 1 0
2 10 0 1 0 0 1 0
2 11 0 0 0 1 1 0
2 12 0 1 0 1 1 0
2 13 0 1 0 1 1 0
2 14 0 0 1 0 1 0
3 0 1 0 1 0 1 0
3 1 0 0 0 0 0 0
3 2 0 0 0 0 0 0
3 3 0 0 0 0 0 0
3 4 1 0 1 0 1 0
3 5 0 0 0 0 0 0
3 6 1 0 1 1 1 0
3 7 0 0 0 0 0 0
3 8 1 0 1 1 1 0
3 9 0 0 0 0 0 0
3 10 1 0 1 0 1 0
3 11 0 0 0 0 0 0
3 12 0 0 0 0 0 0
3 13 0 0 0 0 0 0
3 14 1 0 1 0 1 0
4 0 1 0 0 0 1 0
4 1 0 1 0 1 1 0
4 2 0 1 0 1 1 0
4 3 0 1 0 1 1 0
4 4 0 0 1 0 1 0
4 5 0 0 0 0 0 0
4 6 0 0 0 0 0 0
4 7 0 0 0 0 0 0
4 8 0 0 0 0 0 0
4 9 0 0 0 0 0 0
4 10 1 0 0 0 1 0
4 11 0 1 0 1 1 0
4 12 0 1 0 1 1 0
4 13 0 1 0 1 1 0
4 14 0 0 1 0 1 0
5 0 1 0 1 0 1 0
5 1 0 0 0 0 0 0
5 2 0 0 0 0 0 0
5 3 0 0 0 0 0 0
5 4 1 0 0 0 1 0
5 5 0 1 0 1 1 0
5 6 0 1 1 0 1 0
5 7 0 0 0 0 0 0
5 8 1 1 0 0 1 0
5 9 0 1 0 1 1 0
5 10 0 0 1 0 1 0
5 11 0 0 0 0 0 0
5 12 0 0 0 0 0 0
5 13 0 0 0 0 0 0
5 14 1 0 1 0 1 0
6 0 1 0 0 0 1 0
6 1 0 1 0 1 1 0
6 2 0 1 0 0 1 0
6 3 0 1 0 1 1 0
6 4 0 0 1 0 1 0
6 5 0 0 0 0 0 0
6 6 1 0 1 0 1 0
6 7 0 0 0 0 0 0
6 8 1 0 1 0 1 0
6 9 0 0 0 0 0 0
6 10 1 0 0 0 1 0
6 11 0 1 0 1 1 0
6 12 0 1 0 1 1 0
6 13 0 1 0 1 1 0
6 14 0 0 1 0 1 0
7 0 1 0 1 0 1 0
7 1 0 0 0 0 0 0
7 2 1 0 1 0 1 0
7 3 0 0 0 0 0 0
7 4 1 0 0 0 1 0
7 5 0 1 0 1 1 0
7 6 0 0 0 1 1 0
7 7 0 1 0 0 1 0
7 8 0 0 0 1 1 0
7 9 0 1 0 1 1 0
7 10 0 0 1 0 1 0
7 11 0 0 0 0 0 0
7 12 0 0 0 0 0 0
7 13 0 0 0 0 0 0
7 14 1 0 1 0 1 0
8 0 1 0 1 0 1 0
8 1 0 0 0 0 0 0
8 2 1 0 1 0 1 0
8 3 0 0 0 0 0 0
8 4 1 0 1 0 1 0
8 5 0 0 0 0 0 0
8 6 0 0 0 0 0 0
8 7 1 0 1 0 1 0
8 8 0 0 0 0 0 0
8 9 0 0 0 0 0 0
8 10 1 0 0 0 1 0
8 11 0 1 0 1 1 0
8 12 0 1 1 0 1 0
8 13 0 0 0 0 0 0
8 14 1 0 1 0 1 0
9 0 1 0 1 0 1 0
9 1 0 0 0 0 0 0
9 2 1 0 0 1 1 0
9 3 0 1 0 1 1 0
9 4 0 0 1 0 1 0
9 5 0 0 0 0 0 0
9 6 1 1 0 1 1 0
9 7 0 0 0 1 1 0
9 8 0 1 1 1 1 0
9 9 0 0 0 0 0 0
9 10 1 0 1 0 1 0
9 11 0 0 0 0 0 0
9 12 1 0 1 0 1 0
9 13 0 0 0 0 0 0
9 14 1 0 1 0 1 0
10 0 1 0 1 0 1 0
10 1 0 0 0 0 0 0
10 2 0 0 0 0 0 0
10 3 0 0 0 0 0 0
10 4 1 0 1 0 1 0
10 5 0 0 0 0 0 0
10 6 0 0 0 0 0 0
10 7 0 0 0 0 0 0
10 8 0 0 0 0 0 0
10 9 0 0 0 0 0 0
10 10 1 0 1 0 1 0
10 11 0 0 0 0 0 0
10 12 1 0 1 0 1 0
10 13 0 0 0 0 0 0
10 14 1 0 1 0 1 0
11 0 1 0 0 0 1 0
11 1 0 1 0 1 1 0
11 2 0 1 0 0 1 0
11 3 0 1 0 1 1 0
11 4 0 0 0 0 1 0
11 5 0 1 0 1 1 0
11 6 0 1 0 0 1 0
11 7 0 1 0 1 1 0
11 8 0 1 0 0 1 0
11 9 0 1 0 1 1 0
11 10 0 0 0 0 1 0
11 11 0 1 0 1 1 0
11 12 0 0 0 0 1 0
11 13 0 1 0 1 1 0
11 14 0 0 1 0 1 0
12 0 1 0 1 0 1 0
12 1 0 0 0 0 0 0
12 2 1 0 1 0 1 0
12 3 0 0 0 0 0 0
12 4 1 0 1 0 1 0
12 5 0 0 0 0 0 0
12 6 1 0 1 0 1 0
12 7 0 0 0 0 0 0
12 8 1 0 1 0 1 0
12 9 0 0 0 0 0 0
12 10 1 0 1 0 1 0
12 11 0 0 0 0 0 0
12 12 1 0 1 0 1 0
12 13 0 0 0 0 0 0
12 14 1 0 1 0 1 0
13 0 1 0 1 0 1 0
13 1 0 0 0 0 0 0
13 2 1 0 1 0 1 0
13 3 0 0 0 0 0 0
13 4 1 0 1 0 1 0
13 5 0 0 0 0 0 0
13 6 1 0 1 0 1 0
13 7 0 0 0 0 0 0
13 8 1 0 1 0 1 0
13 9 0 0 0 0 0 0
13 10 1 0 1 0 1 0
13 11 0 0 0 0 0 0
13 12 1 0 1 0 1 0
13 13 0 0 0 0 0 0
13 14 1 0 1 0 1 0
14 0 1 0 0 1 0 1
14 1 0 1 0 1 1 0
14 2 0 0 0 1 1 0
14 3 0 1 0 1 1 0
14 4 0 0 0 1 1 0
14 5 0 1 0 1 1 0
14 6 0 0 0 1 1 0
14 7 0 1 0 1 1 0
14 8 0 0 0 1 1 0
14 9 0 1 0 1 1 0
14 10 0 0 0 1 1 0
14 11 0 1 0 1 1 0
14 12 0 0 0 1 1 0
14 13 0 1 0 1 1 0
14 14 0 0 1 1 0 1
